F    10,1,200

C    20,10,101



NO    ./walls/wall_01.xpm
SO    ./walls/wall_02.xpm
EA    ./walls/wall_03.xpm
WE    ./walls/wall_04.xpm




        1111111111111111111111111
        1000000000110001111000101
        1011000001110001  1000001
        1001000000000001111000001
111111111011000001110000000000001
100000000011000001110111111111111
11110111111111011100000010001
11110111111111011101010010001
11000000110101011100000010001
1000000000000000110001101011
10000000000000001101010011001
1100000111010101111101110N0101
11110111 1110101 101111010011
11111111 1111111 1111111111111111