SO    ./walls/wall_02.xpm
NO    ./walls/wall_01.xpm
EA    ./walls/wall_03.xpm
WE    ./walls/wall_04.xpm



F   255,25,23

C   255,25,25



        1111111111111111111111111
        1000000000110001111000101
        1011000001110001  1000001
        1001000000000001111000001
111111111011000101110000000000011
100000000011000001110111111111111
11110111111111011100000010001
11110111111111011011010010001
11000000110101011100010000001
1000000000000000110010101011
100000000000000011010N1110011
110000011101010111110011010101
11110111 1110101 101111010011
11111111 1111111 1111111111111111
